#######################
S #     #     #   #   #
# ### # # ### # # # ###
#     #   #   # # #   #
########### ### # ### #
# #       #     #   # #
# # # ############# # #
#   #       #     #   #
# ######### # # ##### #
# #   #   # # #       #
# # # # # # # #########
#   #   # #           E
#######################