###########
S   #   # #
### # # # #
# # # # # #
# # # # # #
# #   #   #
# ####### #
#   #   # #
# # # # # #
# #   #   E
###########